XXXXXXXXXXXXXXXXXXXXXXXXXXXXXXXXXXXXXXXXXXXXXXXXXXXXXXXXXXXXXXXXXXXXXXXXXXXXXXXXXXXXXXXXXXXXXXXXXXXXXXXXXXXXXXXXXXXXXXXXXXXXXXXXXXXXXXXXXXXXXXXXXXXXXXXXXXXXXXXXXXXXXXXXXXXXXXXXXXXXXXXXXXXXXXXXXXXXXXXXXXXXXXXXXXXXXXXXXXXXXXXXXXXXXXXXXXXXXXXXXXXXXXXXXX
X........................................................................................................................................................................................................................................................X
X........................................................................................................................................................................................................................................................X
X........................................................................................................................................................................................................................................................X
X................XX..XX............XXXX..................................................................................................................................................................................................................X
X................XX..XX............XXXX..................................................................................................................................................................................................................X
X................XX..XX.............XX...................................................................................................................................................................................................................X
X................XXXXXX.............XX...................................................................................................................................................................................................................X
X................XXXXXX.............XX...................................................................................................................................................................................................................X
X................XX..XX.............XX...................................................................................................................................................................................................................X
X................XX..XX............XXXX..................................................................................................................................................................................................................X
X................XX..XX............XXXX............................XXXXXXXXXXXXXXXXXXXXXXXXXXXXXXXXXXXXXXXXXXXXXXXXXXXX.................................XXXXX............................................................................................X
.........................................................................................................................................................................................................................................................X
...........................................................................................................................................................................XXXXXXXXXXXXXX................................................................X
.........................................................................................................................................................................................................................................................X
................................................................................................................................XXXXXXX..............................................................................XXXXXXXXX...........................X
......XXXXXXXXXXXXXXXXXXXXXXXXXXX........................................................................................................................................................................................................................X
...............................X.........................................................................................................................................................................................................................X
...............................X................................................................................................................................................................XXXXXXXXXXXXXX...........................................X
...............................X.........................................................................................................................................................................................................................X
...............................X..................................XXXXXXXXXXXXXXXXXXXXXX.................................................................................................................................................................X
...............................X..................................XXXXXXXXXXXXXXXXXXXXXX.................................................................................XXXXXXXXXXXXXXXXXX..............................................................X
...............................X.......................XXXXXXXXXXXXXXXXXXXXXXXXXXXXXXXXX.................................................................................................................................................................X
...............................X.......................XXXXXXXXXXXXXXXXXXXXXXXXXXXXXXXXX.................................................................................................................................................................X
...............................X.......................XXXXXXXXXXXXXXXXXXXXXXXXXXXXXXXXX.............................................................XXXXXXXXXXXXXXX.....................................................................................X
...............................X.......................XXXXXXXXXXXXXXXXXXXXXXXXXXXXXXXXX.................................................................................................................................................................X
XXXXXXXXXXXXXXXXXXXXXXXXXXXXXXXXXXXXXX...........XXXXXXXXXXXXXXXXXXXXXXXXXXXXXXXXXXXXXXXXXXXXXXXXXXXXXXXXXXXXXXXXXXXXXXXXXXXXXXXXXXXXXXXXXXXXXXXXXXXXXXXXXXXXXXXXXXXXXXXXXXXXXXXXXXXXXXXXXXXXXXXXXXXXXXXXXXXXXXXXXXXXXXXXXXXXXXXXXXXXXXXXXXXXXXXXXXXXXXXXX
XXXXXXXXXXXXXXXXXXXXXXXXXXXXXXXXXXXXXX...........XXXXXXXXXXXXXXXXXXXXXXXXXXXXXXXXXXXXXXXXXXXXXXXXXXXXXXX...........................XXXXXXXXXXXXXXXXXXXXXXXXXXXXXXXXXXXXXXXXXXXXXXXXXXXXXXXXXXXXXXXXXXXXXXXXXXXXXXXXXXXXXXXXXXXXXXXXXXXXXXXXXXXXXXXXXXXXXXX
XXXXXXXXXXXXXXXXXXXXXXXXXXXXXXXXXXXXXX...........XXXXXXXXXXXXXXXXXXXXXXXXXXXXXXXXXXXXXXXXXXXXXXXXXXXXXXX...........................XXXXXXXXXXXXXXXXXXXXXXXXXXXXXXXXXXXXXXXXXXXXXXXXXXXXXXXXXXXXXXXXXXXXXXXXXXXXXXXXXXXXXXXXXXXXXXXXXXXXXXXXXXXXXXXXXXXXXXX
XXXXXXXXXXXXXXXXXXXXXXXXXXXXXXXXXXXXXX...........XXXXXXXXXXXXXXXXXXXXXXXXXXXXXXXXXXXXXXXXXXXXXXXXXXXXXXX...........................XXXXXXXXXXXXXXXXXXXXXXXXXXXXXXXXXXXXXXXXXXXXXXXXXXXXXXXXXXXXXXXXXXXXXXXXXXXXXXXXXXXXXXXXXXXXXXXXXXXXXXXXXXXXXXXXXXXXXXX