XXXXXXXXXXXXXXXXXXXXXXXXXXXXXXXXXXXXXXXXXXXXXXXXXXXXXXXXXXXXXXXXXXXXXXXXXXXXXXXXXXXXXXXXXXXXXXXXXXXXXXXXXXXXXXXXXXXXXXXXXXXXXXXXXXXXXXXXXXXXXXXXXXXXXXXXXXXXXXXXXXXXXXXXXXXXXXXXXXXXXXXXXXXXXXXXXXXXXXXXXXXXXXXXXXXXXXXXXXXXXXXXXXXXXXXXXXXXXXXXXXXXXXXXXX
X........................................................................................................................................................................................................................................................Q
X........................................................................................................................................................................................................................................................Q
X........................................................................................................................................................................................................................................................Q
X................AD..AD............ATTD..................................................................................................................................................................................................................Q
X................QE..QE............ZXXC..................................................................................................................................................................................................................Q
X................QE..QE.............QE...................................................................................................................................................................................................................Q
X................QXTTXE.............QE...................................................................................................................................................................................................................Q
X................QXOOXE.............QE...................................................................................................................................................................................................................Q
X................QE..QE.............QE...................................................................................................................................................................................................................Q
X................QE..QE............AXXD..................................................................................................................................................................................................................Q
X................ZC..ZC............ZOOC............................ATTTTTTTTTTTTTTTTTTTTTTTTTTTTTTTTTTTTTTTTTTTTTTTTTTD.................................ATTTTD...........................................................................................Q
.........................................................................................................................................................................................................................................................Q
...........................................................................................................................................................................ATTTTTTTTTTTTD................................................................Q
.........................................................................................................................................................................................................................................................Q
................................................................................................................................ATTTTTD..............................................................................ATTTTTTTTD..........................Q
......ATTTTTTTTTTTTTTTTTTTTTTTTTD........................................................................................................................................................................................................................Q
.........................................................................................................................................................................................................................................................Q
................................................................................................................................................................................................ATTTTTTTTTTTTTD..........................................Q
.........................................................................................................................................................................................................................................................Q
..................................................................ATTTTTTTTTTTTTTTTTTTTD.................................................................................................................................................................Q
..................................................................QXXXXXXXXXXXXXXXXXXXXE.................................................................................ATTTTTTTTTTTTTTTTD..............................................................Q
.......................................................ATTTTTTTTTTXXXXXXXXXXXXXXXXXXXXXE.................................................................................................................................................................Q
.......................................................QXXXXXXXXXXXXXXXXXXXXXXXXXXXXXXXE.................................................................................................................................................................Q
.......................................................QXXXXXXXXXXXXXXXXXXXXXXXXXXXXXXXE.............................................................ATTTTTTTTTTTTTTD....................................................................................Q
.......................................................QXXXXXXXXXXXXXXXXXXXXXXXXXXXXXXXE.................................................................................................................................................................Q
ATTTTTTTTTTTTTTTTTTTTTTTTTTTTTTTTTTTTD...........ATTTTTXXXXXXXXXXXXXXXXXXXXXXXXXXXXXXXXXTTTTTTTTTTTTTTTTTTTTTTTTTTTTTTTTTTTTTTTTTTTTTTTTTTTTTTTTTTTTTTTTTTTTTTTTTTTTTTTTTTTTTTTTTTTTTTTTTTTTTTTTTTTTTTTTTTTTTTTTTTTTTTTTTTTTTTTTTTTTTTTTTTTTTTTTTTTTTTTTTX
QXXXXXXXXXXXXXXXXXXXXXXXXXXXXXXXXXXXXE...........QXXXXXXXXXXXXXXXXXXXXXXXXXXXXXXXXXXXXXXXXXXXXXXXXXXXXXE...........................QXXXXXXXXXXXXXXXXXXXXXXXXXXXXXXXXXXXXXXXXXXXXXXXXXEADQEADQXXXXXXXXXXXXXXXXXXXXXXXXXXXXXXXXXXXXXXXXXXXXXXXXXXXXXXXXXXXXE
QXXXXXXXXXXXXXXXXXXXXXXXXXXXXXXXXXXXXE...........QXXXXXXXXXXXXXXXXXXXXXXXXXXXXXXXXXXXXXXXXXXXXXXXXXXXXXE...........................QXXXXXXXXXXXXXXXXXXXXXXXXXXXXXXXXXXXXXXXXXXXXXXXXXE..QE..QXXXXXXXXXXXXXXXXXXXXXXXXXXXXXXXXXXXXXXXXXXXXXXXXXXXXXXXXXXXXE
ZOOOOOOOOOOOOOOOOOOOOOOOOOOOOOOOOOOOOC...........ZOOOOOOOOOOOOOOOOOOOOOOOOOOOOOOOOOOOOOOOOOOOOOOOOOOOOOC...........................ZOOOOOOOOOOOOOOOOOOOOOOOOOOOOOOOOOOOOOOOOOOOOOOOOOOTTTTTTOOOOOOOOOOOOOOOOOOOOOOOOOOOOOOOOOOOOOOOOOOOOOOOOOOOOOOOOOOOOOO