XXXXXXXXXXXXXXXXXXXXXXXXXXXXXXXXXXXXXXXXXXXXXXXXXXXXXXXXXXXXXXXXXXXXXXXXXXXXXXXXXXXXXXXXXXXXXXXXXXXXXXXXXXXXXXXXXXXXXXXXXXXXXXXXXXXXXXXXXXXXXXXXXXXXXXXXXXXXXXXXXXXXXXXXXXXXXXXXXXXXXXXXXXXXXXXXXXXXXXXXXXXXXXXXXXXXXXXXXXXXXXXXXXXXXXXXXXXXXXXXXXXXXXXXXX
X........................................................................................................................................................................................................................................................X
X........................................................................................................................................................................................................................................................X
X........................................................................................................................................................................................................................................................X
X........................................................................................................................................................................................................................................................X
X........................................................................................................................................................................................................................................................X
X........................................................................................................................................................................................................................................................X
X........................................................................................................................................................................................................................................................X
X........................................................................................................................................................................................................................................................X
X........................................................................................................................................................................................................................................................X
X........................................................................................................................................................................................................................................................X
X..................................................................XXXXXXXXXXXXXXXXXXXXXXXXXXXXXXXXXXXXXXXXXXXXXXXXXXXX.................................XXXXX............................................................................................X
.........................................................................................................................................................................................................................................................X
...........................................................................................................................................................................XXXXXXXXXXXXXX................................................................X
.........................................................................................................................................................................................................................................................X
................................................................................................................................XXXXXXX..............................................................................XXXXXXXXX...........................X
......XXXXXXXXXXXXXXXXXXXXXXXXXXX........................................................................................................................................................................................................................X
.........................................................................................................................................................................................................................................................X
................................................................................................................................................................................................XXXXXXXXXXXXXX...........................................X
.........................................................................................................................................................................................................................................................X
..................................................................XXXXXXXXXXXXXXXXXXXXXX.................................................................................................................................................................X
..................................................................XXXXXXXXXXXXXXXXXXXXXX.................................................................................XXXXXXXXXXXXXXXXXX..............................................................X
.......................................................XXXXXXXXXXXXXXXXXXXXXXXXXXXXXXXXX.................................................................................................................................................................X
.......................................................XXXXXXXXXXXXXXXXXXXXXXXXXXXXXXXXX.................................................................................................................................................................X
.......................................................XXXXXXXXXXXXXXXXXXXXXXXXXXXXXXXXX.............................................................XXXXXXXXXXXXXXX.....................................................................................X
.......................................................XXXXXXXXXXXXXXXXXXXXXXXXXXXXXXXXX.................................................................................................................................................................X
XXXXXXXXXXXXXXXXXXXXXXXXXXXXXXXXXXXXXX...........XXXXXXXXXXXXXXXXXXXXXXXXXXXXXXXXXXXXXXXXXXXXXXXXXXXXXXXXXXXXXXXXXXXXXXXXXXXXXXXXXXXXXXXXXXXXXXXXXXXXXXXXXXXXXXXXXXXXXXXXXXXXXXXXXXXXXXXXXXXXXXXXXXXXXXXXXXXXXXXXXXXXXXXXXXXXXXXXXXXXXXXXXXXXXXXXXXXXXXXXX
XXXXXXXXXXXXXXXXXXXXXXXXXXXXXXXXXXXXXX...........XXXXXXXXXXXXXXXXXXXXXXXXXXXXXXXXXXXXXXXXXXXXXXXXXXXXXXXXXXXXXXXXXXXXXXXXXXXXXXXXXXXXXXXXXXXXXXXXXXXXXXXXXXXXXXXXXXXXXXXXXXXXXXXXXXXXXXXXXXXXXXXXXXXXXXXXXXXXXXXXXXXXXXXXXXXXXXXXXXXXXXXXXXXXXXXXXXXXXXXXX
XXXXXXXXXXXXXXXXXXXXXXXXXXXXXXXXXXXXXX...........XXXXXXXXXXXXXXXXXXXXXXXXXXXXXXXXXXXXXXXXXXXXXXXXXXXXXXXXXXXXXXXXXXXXXXXXXXXXXXXXXXXXXXXXXXXXXXXXXXXXXXXXXXXXXXXXXXXXXXXXXXXXXXXXXXXXXXXXXXXXXXXXXXXXXXXXXXXXXXXXXXXXXXXXXXXXXXXXXXXXXXXXXXXXXXXXXXXXXXXXX
XXXXXXXXXXXXXXXXXXXXXXXXXXXXXXXXXXXXXX...........XXXXXXXXXXXXXXXXXXXXXXXXXXXXXXXXXXXXXXXXXXXXXXXXXXXXXXXXXXXXXXXXXXXXXXXXXXXXXXXXXXXXXXXXXXXXXXXXXXXXXXXXXXXXXXXXXXXXXXXXXXXXXXXXXXXXXXXXXXXXXXXXXXXXXXXXXXXXXXXXXXXXXXXXXXXXXXXXXXXXXXXXXXXXXXXXXXXXXXXXX