XXXXXXXXXXXXXXXXXXXXXXXXXXXXXXXXXXXXXXXXXXXXXXXXXXXXXXXXXXXXXXXXXXXXXXXXXXXXXXXXXXXXXXXXXXXXXXXXXXXXXXXXXXXXXXXXXXXXXXXXXXXXXXXXXXXXXXXXXXXXXXXXXXXXXXXXXXXXXXXXXXXXXXXXXXXXXXXXXXXXXXXXXXXXXXXXXXXXXXXXXXXXXXXXXXXXXXXXXXXXXXXXXXXXXXXXXXXXXXXXXXXXXXXXXX
..........................................................................................................................................................................................................................................................
..........................................................................................................................................................................................................................................................
..........................................................................................................................................................................................................................................................
..........................................................................................................................................................................................................................................................
..........................................................................................................................................................................................................................................................
..........................................................................................................................................................................................................................................................
..........................................................................................................................................................................................................................................................
..........................................................................................................................................................................................................................................................
..........................................................................................................................................................................................................................................................
..........................................................................................................................................................................................................................................................
...................................................................ATTTTTTTTTTTTTTTTTTTTTTTTTTTTTTTTTTTTTTTTTTTTTTTTTTD.................................ATTTTD............................................................................................
..........................................................................................................................................................................................................................................................
...........................................................................................................................................................................ATTTTTTTTTTTTD.................................................................
..........................................................................................................................................................................................................................................................
................................................................................................................................ATTTTTD..............................................................................ATTTTTTTTD...........................
......ATTTTTTTTTTTTTTTTTTTTTTTTTD.........................................................................................................................................................................................................................
..........................................................................................................................................................................................................................................................
................................................................................................................................................................................................ATTTTTTTTTTTTTD...........................................
..........................................................................................................................................................................................................................................................
..................................................................ATTTTTTTTTTTTTTTTTTTTD..................................................................................................................................................................
..................................................................QXXXXXXXXXXXXXXXXXXXXE.................................................................................ATTTTTTTTTTTTTTTTD...............................................................
.......................................................ATTTTTTTTTTXXXXXXXXXXXXXXXXXXXXXE..................................................................................................................................................................
.......................................................QXXXXXXXXXXXXXXXXXXXXXXXXXXXXXXXE..................................................................................................................................................................
.......................................................QXXXXXXXXXXXXXXXXXXXXXXXXXXXXXXXE.............................................................ATTTTTTTTTTTTTTD.....................................................................................
.......................................................QXXXXXXXXXXXXXXXXXXXXXXXXXXXXXXXE..................................................................................................................................................................
ATTTTTTTTTTTTTTTTTTTTTTTTTTTTTTTTTTTTD...........ATTTTTXXXXXXXXXXXXXXXXXXXXXXXXXXXXXXXXXTTTTTTTTTTTTTTTTTTTTTTTTTTTTTTTTTTTTTTTTTTTTTTTTTTTTTTTTTTTTTTTTTTTTTTTTTTTTTTTTTTTTTTTTTTTTTTTTTTTTTTTTTTTTTTTTTTTTTTTTTTTTTTTTTTTTTTTTTTTTTTTTTTTTTTTTTTTTTTTTTX
QXXXXXXXXXXXXXXXXXXXXXXXXXXXXXXXXXXXXE...........QXXXXXXXXXXXXXXXXXXXXXXXXXXXXXXXXXXXXXXXXXXXXXXXXXXXXXXOOOOOOOOOOOOOOOOOOOOOOOOOOOXXXXXXXXXXXXXXXXXXXXXXXXXXXXXXXXXXXXXXXXXXXXXXXXXXEADQEADQXXXXXXXXXXXXXXXXXXXXXXXXXXXXXXXXXXXXXXXXXXXXXXXXXXXXXXXXXXXXE
QXXXXXXXXXXXXXXXXXXXXXXXXXXXXXXXXXXXXE...........QXXXXXXXXXXXXXXXXXXXXXXXXXXXXXXXXXXXXXXXXXXXXXXXXXXXXXE...........................QXXXXXXXXXXXXXXXXXXXXXXXXXXXXXXXXXXXXXXXXXXXXXXXXXE..QE..QXXXXXXXXXXXXXXXXXXXXXXXXXXXXXXXXXXXXXXXXXXXXXXXXXXXXXXXXXXXXE
ZOOOOOOOOOOOOOOOOOOOOOOOOOOOOOOOOOOOOC...........ZOOOOOOOOOOOOOOOOOOOOOOOOOOOOOOOOOOOOOOOOOOOOOOOOOOOOOC...........................ZOOOOOOOOOOOOOOOOOOOOOOOOOOOOOOOOOOOOOOOOOOOOOOOOOOOOOOOOOOOOOOOOOOOOOOOOOOOOOOOOOOOOOOOOOOOOOOOOOOOOOOOOOOOOOOOOOOOOOO